111111111111111111111
10C1000000000000000C1
100001000C00010011011
1P0C01000000001111011
111111110111000000001
110110100011111011111
110110111001110001111
110C000000000C0000011
1111E0100000000011111
1111101000C0000000011
1111111001110000C0001
111111111111111111111